1111111111111111
1C0001C0000000E1
1111100011111111
1C00000D1C0C0001
1000D00010C00001
1011111111111011
10000D0000000001
10000C1C00000001
1111111111111001
10P10C01CC000001
1001000100000001
1C0000D0000C0001
1111111111111111