1111111111111111
1000000000000E01
1000000000000001
1000000000000001
1000000000000001
1000000000D00001
1000000000000001
100000000D000001
1000000000000001
10P0000000000001
1000000000000001
1111111111111111