1111111111111111
1000000000000001
100000000C000001
1000000000000001
10C0000000D00001
1000000000000001
1000000111000001
10000001E100C001
1000000111000001
1000000000D00001
1P00000000000001
1111111111111111